32
32
10600000000000000000000000000000
00000000000000000009000000060000
00000000000000000009000000000000
00000000000000000009000060000000
09999990000000000000000000000000
09999990000999999999999000000000
09999990000000000999999999000000
09999990000000000000000099999990
00000000000000000000000000000000
00000600000000000000060000099999
00000000000000000000000000090000
00000000000000000000000000090000
99000000060000090000000000099900
09900000000000090000000000000900
00990000000000090009999999990900
00099000000000090000000000000900
00009000000000000000000000000900
00009000999000900000000000009900
00009900000000090000000600000900
00099000000000090000000000000900
00990000000000090000000000000900
09900000000000090000000000000999
99000000600000090000000006000000
00000000000000000000000000000000
00000000000000000000000999999999
00000000000000000000000999000000
09999999009000099900000999000000
00000000009000000000000000000000
00000006009000000000000000000000
00000000009000000000000000000000
00006000009000000000000000000000
00000000000000000000000000000602